= = = = = = = = = = = = = = = = = = = = = = = = = = = = = = = = = = = =
= . . . . . . . . . . . . . . . . . . . . . . . . . . . . . . . . . . =
= . . . . . . . . . . . . . . . . . . . . . . . . . . . . . . . . . . =
= . . . . . . . . . . . . . . . . . . . . . . . . . . . . . . . . . . =
= @ . . = . . . . . . . . . . . . . . . . . . . . . . . . . = . . . ! =
= . . . = . . . . . . . . . . . . . . . . . . . . . . . . . = . . . . =
= . . . = . . . . . . . . . . . . . . . . . . . . . . . . . = . . . . =
= . . . = . . . . . . . . . . . . . . . . . . . . . . . . . = . . . . =
= . . . = . . . . . . . . . . . . . . . . . . . . . . . . . = . . . . =
= . . . = . . . . . . . . . . . . . . . . . . . . . . . . . = . . . . =
= . . . = . . . . . . . . . . . . . . . . . . . . . . . . . = . . . . =
= . . . = . . . . . . . . . . . . . . . . . . . . . . . . . = . . . . =
= . . . = . . . . . . . . . . . . . . . . . . . . . . . . . = . . . . =
= . . . = . . . . . . . . . . . . . . . . . . . . . . . . . = . . . . =
= . . . = . . . . . . . . . . . . . . . . . . . . . . . . . = . . . . =
= . . . = . . . . . . . . . . . . . . . . . . . . . . . . . = . . . . =
= . . . = . . . . . . . . . . . . . . . . . . . . . . . . . = . . . . =
= . . . = . . . . . . . . . . . . . . . . . . . . . . . . . = . . . . =
= ! . . = . . . . . . . . . . . . . . . . . . . . . . . . . = . . . @ =
= . . . . . . . . . . . . . . . . . . . . . . . . . . . . . . . . . . =
= . . . . . . . . . . . . . . . . . . . . . . . . . . . . . . . . . . =
= . . . . . . . . . . . . . . . . . . . . . . . . . . . . . . . . . . =
= = = = = = = = = = = = = = = = = = = = = = = = = = = = = = = = = = = =
