= = = = = = = = = = = = = = = = = = = = = = = = = = = = = = = = = = = =
= . . . . . . . . . . . . . . . . . . . . . . . . . . . . . . . . . . =
= . . . . . . . . . . . . . . . . . . . . . . . . . . . . . . . . . . =
= . . . . . . . . . . . . . . . . . . . . . . . . . . . . . . . . . . =
= . . . . . . . . . . . . . . . . . . . . . . . = . . . . . . . . . . =
= . . . . . . . . . . . . . . . . . . . . . . . = . . . . . . . . . . =
= . . . . . . . . . . . . . . . . . . . . . . . = . . . . . . . . . . =
= . . . . . . . . . . . . . . . . . . . . . . . = . . . . . . . . . . =
= . . . . . . . . . . . . . . . . . . . . . . . = . . . . . . . . . . =
= . . . . . . . . . . . . . . . . . . . . . . . = . . . . . . . . . . =
= . . . . . . . . . . . . . . . . . . . . . . . = . . . . . . . . . . =
= . . . . . . . . . . . . . . . . . . . . . . . = . . . . . . . . . . =
= . . . . . . . . . . . . . . . . . . . . . . . = . . . . . . . . . . =
= . . . . . . . . . . . . . . . . . . . . . . . = . . . . . . . . . . =
= . . . . . . . . . . . . . . . . . . . . . . . = . . . . . . . . . . =
= . . . . . . . . . . . . . . . . . . . . . . . = . . . . . . . . . . =
= . . . . . . . . . . . . . . . . . . . . . . . = . . . . . . . . . . =
= . . . . . . . . . . . . . . . . . . . . . . . = . . . . . . . . . . =
= . . . . . . . . . . . . . . . . . . . . . . . . . . . . . . . . . . =
= . . . . . . . . . . . . . . . . . . . . . . . . . . . . . . . . . . =
= . . . . . . . . . . . . . . . . . . . . . . . . . . . . . . . . . . =
= . . . . . . . . . . . . . . . . . . . . . . . . . . . . . . . . . . =
= = = = = = = = = = = = = = = = = = = = = = = = = = = = = = = = = = = =
